15 15
1 1 1 1 1 1 1 1 1 1 1 1 6 6 6 
1 1 1 1 1 1 1 1 1 1 1 1 6 6 6 
1 1 1 1 -1 1 1 1 1 1 1 1 1 6 6 
1 1 1 1 1 1 1 1 1 1 1 1 1 1 1 
1 1 1 1 1 1 1 1 1 1 1 1 1 1 1 
1 1 1 1 1 1 1 1 1 1 1 1 1 1 1 
1 1 1 1 1 1 1 1 1 1 1 1 1 1 1 
1 1 1 1 1 1 1 1 1 1 1 1 1 1 1 
1 1 1 1 1 1 1 1 1 1 1 1 1 3 1 
1 1 1 1 1 1 1 1 1 1 1 1 3 3 1 
1 1 1 1 1 1 1 1 1 1 1 3 3 3 3 
1 1 1 1 1 1 2 1 1 1 3 3 3 3 3 
1 1 1 1 -1 1 4 1 1 3 3 3 6 6 6 
1 1 1 1 1 1 5 1 1 3 3 3 6 6 6 
1 1 1 1 1 1 1 1 1 1 3 3 3 6 6 