15 15
1 1 1 1 1 1 1 6 6 6 1 1 1 1 1 
1 1 1 1 1 1 1 6 6 6 1 1 1 1 1 
1 1 1 1 1 1 1 6 6 6 1 1 -1 1 1 
1 1 5 1 3 3 1 1 6 6 5 1 1 1 1 
1 1 1 3 3 3 1 1 1 1 1 1 1 1 1 
1 1 1 3 3 3 3 4 4 4 1 1 1 1 1 
1 1 1 3 3 3 1 2 4 4 1 1 1 1 1 
1 1 1 1 1 1 1 4 4 4 2 1 1 1 1 
1 1 1 1 1 1 2 4 4 4 1 1 1 1 1 
1 1 1 1 1 1 1 4 2 1 3 3 1 1 1 
1 1 1 1 1 1 1 4 4 3 3 3 1 1 1 
1 1 1 1 1 5 1 1 1 1 3 3 5 1 1 
1 1 -1 1 1 1 1 6 6 1 3 3 1 1 1 
1 1 1 1 1 1 1 6 6 1 1 1 1 1 1 
1 1 1 1 1 1 1 6 6 1 1 1 1 1 1 